||||||||||
| |    | |
| . ||   |
| | |   X|
| |||| |.|
| | |    O
| ||||||.|
| |      |
| | ||||||
| . |    |
|||||||||| 