||||||||||||||||||||
|X| . |    | .     |
|.| | |    | |     |
| | | |    | |     |
|.| | .    | |     |
| | | |||||| |     |
| | |        |     |
| | ||||||||||     |
|.| .        |     |
| | |        |     |
| | |        |     |
| |.|        |     |
|.| .        |     |
| | |        |     |
| | |        |     |
| | |        |     |
| | |        |     |
|.| |        |     |
|   |        |     O
||||||||||||||||||||