||||||||||||||||||||
|X| | .    | .     |
|.| | |    | |     |
| | | |    | |     |
|.| | |    | |     |
| ||| ||||.| |     |
| . |    |   |     |
||| ||||.|||||     |
| | |        ||||  |
| . |        .  |  |
| ||||||||||||  |  |
| | |  |     |  |  |
|.| .  |     |  |  |
| | |  .     |  |  |
| | |  |     |  |  |
| | |||||.||||  |  |
| | |        |  |  |
|.| |        |  |  |
|   |        .  |  |
|||||||||||||||||..|
| |   .    | .     |
|.| |||    | |||||||
| | | |||| | |     |
|.| | .    | |     |
| | | |||||| |     |
| | |        |     |
| | ||||||||||     |
|.| .        |     |
| . |        |     |
| |||        |     |
| |.||||||||||     |
|.| .        |     |
| | |.||||||||     |
| | |        |     |
| | ||||||||.|     |
| | |        |     |
|.| |.||||||||     |
|   |        .     O
||||||||||||||||||||